1178

SARDINIAM - OCCVPATAS - BELLO 0 SERVILI . RECIPERAVI?
COLONIAS - IN - AFRICA - SICILIA - Mae-:DONIA - VTRAQVE - HISPANIA - ἐκ Galsa Con-ata et 85

GADLIA - N ARBONENSI - PRaeter meoiDIA - Ml LITVM . DE Dvx17 ITALIA - AVTem colon-⁸·—

AS - QVAE 0 Vtvo . ME - CELEBERRIMAE - E‘r - FREQVENTISSIMAE - FVERVNT - ιω

DEDVCTAS - HABET7
- A M ISSA . D EVI CTIS legioniba· recept·

SIGN A - M 1 LITARIA - COMPLVRA . per nostr-202 dueES ί
Ex - HISPANIA - ET . GENtt'buae Det-ATEIS7 PARTHOS - TRIVM - EXERCITVVM . ROMANO 40
RVM - SPOLIA . ΕΤ - SIGNA restit-nere MIHI . SVPPLICESQVE 0 AMICITlAM - POPVLI - ROMANI

PETERE - col-:01 - EA - AVTEM - SIGNA- IN - PENETRALI · QVOD · EST - IN - TEMPLO . MARTIS - VI„

TORIS - REPOSVI?
PANNONIORVM - GENTES 0 QVAS - ANTE - ΜΕ . PRINCIPEM . POPVLI - ROMANI . EXERCITVS - NVN

QVAM - AD 1’1· - DEVICTAS - PER - '1'1 - CAESAREM - QVI - TVM - PRAEERat exe-vitibvs ⁴5
IMPERIO - POPVLI - ROMANI - SVBIECI - PROTV LIQVE - FINffl . impu-ii aad luri FLVMIN IS
⁶ EXERCITVS - · BIS - - - SPRO - - - 0 A .

rupem - - ‘- QVOD . A . - V - - - - VS -
velvs -

TVS Qv E - - - . - - 1³05

GENTES - 1

AD - ME . Ex - ’1:513612 - - . -
APVD - Qv - 0 Q u - NOSTRAM- -

PER - LEGAeoae BASTARNARVM - - . Ν - - - ΕΤ -

‚50

uouunwruu nmmum

‘SARnu-tanvm ” -

Fon-t- PROVINCIAS - OMNIS - QVAE . TRANS . HADRIANVM - MARS - VERGVNT - et Pone-'m Δσίο-

Vs. 82 ⁸⁸-
NASQVE - IAM - Ex - MAGNA - PARTE . Rssolssvs - EAS - POSSIDENTIBVS - et Siciliam et

SIGNA ο MILITARIA - COMPLVRA · per mm duem . AMISSA - Dvacns - &epm—omneis·- recepi
Ex - HISPANIA . ET - ’ - . - - -

Vs- ⁸9 doc Fott-

ss-——A„

 

